"aa" = (/turf/closed/wall/mineral/plastitanium,/area/shuttle/arrival)
"ab" = (/obj/machinery/door/airlock/shuttle{name = "Arrival Shuttle Airlock"},/turf/open/floor/mineral/plastitanium,/area/shuttle/arrival)
"ac" = (/turf/closed/wall/mineral/titanium,/area/shuttle/arrival)
"ad" = (/obj/structure/sign/nanotrasen,/turf/closed/wall/mineral/titanium/nodiagonal,/area/shuttle/arrival)
"ae" = (/turf/closed/wall/mineral/titanium/nodiagonal,/area/shuttle/arrival)
"af" = (/obj/structure/window/shuttle,/obj/structure/grille,/turf/open/floor/plating,/area/shuttle/arrival)
"ag" = (/turf/template_noop,/area/template_noop)
"ah" = (/obj/structure/sign/warning/fire,/turf/closed/wall/mineral/titanium,/area/shuttle/arrival)
"ai" = (/obj/effect/turf_decal/stripes{dir = 1},/turf/open/floor/mineral/titanium/white,/area/shuttle/arrival)
"aj" = (/obj/effect/turf_decal/stripes{dir = 1},/obj/item/twohanded/required/kirbyplants/random,/turf/open/floor/mineral/titanium/white,/area/shuttle/arrival)
"ak" = (/obj/structure/toilet,/obj/structure/window{dir = 8},/obj/structure/window{dir = 4; icon_state = "window"},/obj/structure/curtain,/turf/open/floor/mineral/titanium/white,/area/shuttle/arrival)
"al" = (/turf/open/floor/mineral/titanium/white,/area/shuttle/arrival)
"am" = (/obj/structure/chair/comfy/shuttle,/turf/open/floor/mineral/titanium/white,/area/shuttle/arrival)
"an" = (/turf/open/floor/plating,/area/shuttle/arrival)
"ao" = (/obj/machinery/status_display/evac{pixel_y = 32},/turf/open/floor/mineral/titanium/white,/area/shuttle/arrival)
"ap" = (/obj/structure/shuttle/engine/heater,/turf/open/floor/plating,/area/shuttle/arrival)
"aq" = (/obj/item/twohanded/required/kirbyplants/random,/turf/open/floor/mineral/titanium/white,/area/shuttle/arrival)
"ar" = (/obj/structure/chair/comfy/shuttle{dir = 4},/obj/effect/turf_decal/tile/purple{dir = 4},/turf/open/floor/mineral/titanium/white,/area/shuttle/arrival)
"as" = (/obj/structure/chair/comfy/shuttle,/obj/structure/window{dir = 1; icon_state = "window"},/turf/open/floor/mineral/titanium/white,/area/shuttle/arrival)
"at" = (/obj/structure/sign/nanotrasen,/turf/closed/wall/mineral/titanium,/area/shuttle/arrival)
"au" = (/obj/structure/chair/comfy/shuttle{dir = 4},/obj/machinery/status_display/evac{pixel_x = -32; pixel_y = 0},/turf/open/floor/mineral/titanium/white,/area/shuttle/arrival)
"av" = (/obj/structure/chair/comfy/shuttle{dir = 8; icon_state = "shuttle_chair"},/obj/machinery/status_display/evac{pixel_x = 32; pixel_y = 0},/turf/open/floor/mineral/titanium/white,/area/shuttle/arrival)
"aw" = (/obj/structure/chair/comfy/shuttle{dir = 8; icon_state = "shuttle_chair"},/turf/open/floor/mineral/titanium/white,/area/shuttle/arrival)
"ax" = (/obj/structure/chair/comfy/shuttle{dir = 4},/obj/structure/window{dir = 8},/turf/open/floor/mineral/titanium/white,/area/shuttle/arrival)
"ay" = (/obj/structure/chair/comfy/shuttle{dir = 8; icon_state = "shuttle_chair"},/obj/structure/window{dir = 4; icon_state = "window"},/turf/open/floor/mineral/titanium/white,/area/shuttle/arrival)
"az" = (/obj/structure/chair/comfy/shuttle{dir = 4},/turf/open/floor/mineral/titanium/white,/area/shuttle/arrival)
"aA" = (/obj/structure/shuttle/engine/propulsion,/turf/template_noop,/area/shuttle/arrival)
"aB" = (/obj/structure/chair/comfy/shuttle{dir = 1},/turf/open/floor/mineral/titanium/white,/area/shuttle/arrival)
"aC" = (/obj/machinery/requests_console{department = "Arrival shuttle"; name = "Arrivals Shuttle console"},/turf/closed/wall/mineral/titanium,/area/shuttle/arrival)
"aD" = (/obj/structure/table/glass,/obj/item/radio,/obj/item/radio,/obj/item/razor,/turf/open/floor/mineral/titanium/white,/area/shuttle/arrival)
"aE" = (/obj/structure/table/glass,/obj/item/radio,/obj/item/radio,/obj/item/lighter,/obj/item/wirecutters,/turf/open/floor/mineral/titanium/white,/area/shuttle/arrival)
"aF" = (/turf/template_noop,/area/shuttle/arrival)
"aG" = (/obj/structure/shuttle/engine/large,/turf/template_noop,/area/shuttle/arrival)
"aH" = (/obj/machinery/door/airlock/shuttle{name = "Arrival Shuttle Airlock"},/obj/docking_port/mobile/arrivals{dir = 2; port_direction = 1; preferred_direction = 4},/turf/open/floor/mineral/plastitanium,/area/shuttle/arrival)
"aI" = (/obj/item/camera_film,/obj/item/twohanded/required/kirbyplants/random,/turf/open/floor/mineral/titanium/white,/area/shuttle/arrival)
"aJ" = (/obj/effect/turf_decal/arrows{dir = 1; icon_state = "arrows"},/obj/machinery/light{dir = 8},/turf/open/floor/mineral/titanium/white,/area/shuttle/arrival)
"aK" = (/obj/item/cardboard_cutout,/obj/item/twohanded/required/kirbyplants/random,/turf/open/floor/mineral/titanium/white,/area/shuttle/arrival)
"aL" = (/obj/structure/light_prism,/obj/effect/turf_decal/stripes/box,/obj/item/toy/spinningtoy,/turf/open/floor/plating,/area/shuttle/arrival)
"aM" = (/obj/structure/chair/comfy/shuttle{dir = 8; icon_state = "shuttle_chair"},/obj/structure/window{dir = 4; icon_state = "window"},/obj/item/toy/gun,/turf/open/floor/mineral/titanium/white,/area/shuttle/arrival)
"aN" = (/obj/effect/turf_decal/arrows{dir = 1; icon_state = "arrows"},/obj/machinery/light{dir = 4},/turf/open/floor/mineral/titanium/white,/area/shuttle/arrival)
"aO" = (/obj/structure/chair/comfy/shuttle{dir = 1},/obj/machinery/light,/turf/open/floor/mineral/titanium/white,/area/shuttle/arrival)
"aP" = (/obj/structure/chair/comfy/shuttle{dir = 4},/obj/machinery/light{dir = 8},/turf/open/floor/mineral/titanium/white,/area/shuttle/arrival)
"aQ" = (/obj/machinery/vending/cola,/turf/open/floor/mineral/titanium/white,/area/shuttle/arrival)
"aR" = (/obj/structure/chair/comfy/shuttle,/obj/item/bikehorn,/turf/open/floor/mineral/titanium/white,/area/shuttle/arrival)
"aS" = (/obj/structure/chair/comfy/shuttle{dir = 8; icon_state = "shuttle_chair"},/obj/machinery/light{dir = 4},/turf/open/floor/mineral/titanium/white,/area/shuttle/arrival)
"aT" = (/obj/effect/turf_decal/arrows{dir = 1; icon_state = "arrows"},/turf/open/floor/mineral/titanium/white,/area/shuttle/arrival)
"aU" = (/obj/structure/closet/emcloset,/obj/machinery/light,/turf/open/floor/mineral/titanium/white,/area/shuttle/arrival)
"aV" = (/obj/structure/table/glass,/obj/item/phone,/obj/item/megaphone,/turf/open/floor/mineral/titanium/white,/area/shuttle/arrival)
"aX" = (/obj/structure/table/glass,/obj/item/camera,/obj/item/book/random,/turf/open/floor/mineral/titanium/white,/area/shuttle/arrival)
"aY" = (/obj/structure/table/glass,/obj/item/electronics/apc,/obj/item/c_tube,/obj/item/wrench,/turf/open/floor/mineral/titanium/white,/area/shuttle/arrival)
"ba" = (/obj/effect/turf_decal/tile/red,/turf/open/floor/mineral/titanium/white,/area/shuttle/arrival)
"bb" = (/obj/effect/turf_decal/stripes/line{dir = 9},/turf/open/floor/mineral/titanium/white,/area/shuttle/arrival)
"bc" = (/obj/structure/chair/comfy/shuttle{dir = 8; icon_state = "shuttle_chair"},/obj/effect/turf_decal/stripes/line{dir = 1},/turf/open/floor/mineral/titanium/white,/area/shuttle/arrival)
"bd" = (/obj/structure/chair/comfy/shuttle{dir = 4},/obj/structure/window{dir = 8},/obj/effect/turf_decal/stripes/line{dir = 1},/turf/open/floor/mineral/titanium/white,/area/shuttle/arrival)
"be" = (/obj/effect/turf_decal/stripes/line{dir = 5},/turf/open/floor/mineral/titanium/white,/area/shuttle/arrival)
"bg" = (/obj/machinery/newscaster,/turf/closed/wall/mineral/titanium,/area/shuttle/arrival)
"bi" = (/obj/structure/chair/comfy/shuttle{dir = 8; icon_state = "shuttle_chair"},/obj/structure/window{dir = 4; icon_state = "window"},/obj/effect/turf_decal/stripes/line{dir = 1},/turf/open/floor/mineral/titanium/white,/area/shuttle/arrival)
"bj" = (/obj/structure/chair/comfy/shuttle{dir = 4},/obj/effect/turf_decal/stripes/line{dir = 1},/turf/open/floor/mineral/titanium/white,/area/shuttle/arrival)
"bk" = (/obj/effect/turf_decal/stripes/line{dir = 8},/turf/open/floor/mineral/titanium/white,/area/shuttle/arrival)
"bl" = (/obj/effect/turf_decal/stripes/line{dir = 4},/turf/open/floor/mineral/titanium/white,/area/shuttle/arrival)
"bm" = (/obj/structure/light_prism,/obj/effect/turf_decal/stripes/box,/turf/open/floor/plating,/area/shuttle/arrival)
"bn" = (/obj/effect/turf_decal/stripes/line{dir = 10},/turf/open/floor/mineral/titanium/white,/area/shuttle/arrival)
"bo" = (/obj/structure/chair/comfy/shuttle{dir = 8; icon_state = "shuttle_chair"},/obj/effect/turf_decal/stripes/line,/turf/open/floor/mineral/titanium/white,/area/shuttle/arrival)
"bp" = (/obj/structure/chair/comfy/shuttle{dir = 4},/obj/structure/window{dir = 8},/obj/effect/turf_decal/stripes/line,/turf/open/floor/mineral/titanium/white,/area/shuttle/arrival)
"bq" = (/obj/effect/turf_decal/stripes/line{dir = 6},/turf/open/floor/mineral/titanium/white,/area/shuttle/arrival)
"br" = (/obj/structure/chair/comfy/shuttle{dir = 8; icon_state = "shuttle_chair"},/obj/structure/window{dir = 4; icon_state = "window"},/obj/effect/turf_decal/stripes/line,/turf/open/floor/mineral/titanium/white,/area/shuttle/arrival)
"bs" = (/obj/structure/chair/comfy/shuttle{dir = 4},/obj/effect/turf_decal/stripes/line,/turf/open/floor/mineral/titanium/white,/area/shuttle/arrival)
"bw" = (/obj/structure/table/glass,/obj/item/soap,/obj/item/organ/liver,/obj/item/coin/silver,/turf/open/floor/mineral/titanium/white,/area/shuttle/arrival)
"bx" = (/obj/structure/table/glass,/obj/item/rod_of_asclepius,/obj/item/defibrillator,/obj/item/taperecorder,/turf/open/floor/mineral/titanium/white,/area/shuttle/arrival)
"bz" = (/obj/effect/turf_decal/tile/green,/turf/open/floor/mineral/titanium/white,/area/shuttle/arrival)
"bA" = (/obj/effect/turf_decal/tile/green{dir = 8},/turf/open/floor/mineral/titanium/white,/area/shuttle/arrival)
"bB" = (/obj/effect/turf_decal/tile/red{dir = 4},/obj/effect/turf_decal/tile/red{dir = 1},/turf/open/floor/mineral/titanium/white,/area/shuttle/arrival)
"bC" = (/obj/effect/turf_decal/tile/red{dir = 1},/turf/open/floor/mineral/titanium/white,/area/shuttle/arrival)
"bD" = (/obj/effect/turf_decal/tile/purple,/obj/effect/turf_decal/tile/purple{dir = 8},/turf/open/floor/mineral/titanium/white,/area/shuttle/arrival)
"bE" = (/obj/machinery/icecream_vat,/obj/effect/turf_decal/tile/green{dir = 4},/turf/open/floor/mineral/titanium/white,/area/shuttle/arrival)
"bF" = (/obj/effect/turf_decal/tile/green{dir = 1},/turf/open/floor/mineral/titanium/white,/area/shuttle/arrival)
"bG" = (/obj/effect/turf_decal/tile/blue,/turf/open/floor/mineral/titanium/white,/area/shuttle/arrival)
"bH" = (/obj/structure/closet/emcloset,/turf/open/floor/mineral/titanium/white,/area/shuttle/arrival)
"bJ" = (/obj/effect/turf_decal/tile/purple{dir = 1},/turf/open/floor/mineral/titanium/white,/area/shuttle/arrival)
"bK" = (/obj/effect/turf_decal/stripes/line{dir = 4},/obj/effect/turf_decal/tile/brown{dir = 8},/turf/open/floor/mineral/titanium/white,/area/shuttle/arrival)
"bL" = (/obj/structure/chair/comfy/shuttle{dir = 4},/obj/effect/turf_decal/tile/brown,/obj/effect/turf_decal/tile/brown{dir = 4},/turf/open/floor/mineral/titanium/white,/area/shuttle/arrival)
"bM" = (/obj/effect/turf_decal/stripes/line{dir = 4},/obj/effect/turf_decal/tile/brown{dir = 1},/turf/open/floor/mineral/titanium/white,/area/shuttle/arrival)
"bN" = (/obj/effect/turf_decal/stripes/line{dir = 10},/obj/effect/turf_decal/tile/yellow,/obj/effect/turf_decal/tile/yellow{dir = 4},/turf/open/floor/mineral/titanium/white,/area/shuttle/arrival)
"bO" = (/obj/effect/turf_decal/tile/yellow,/obj/effect/turf_decal/tile/yellow{dir = 4},/turf/open/floor/mineral/titanium/white,/area/shuttle/arrival)
"bP" = (/mob/living/carbon/monkey,/turf/open/floor/plating,/area/shuttle/arrival)
"bQ" = (/obj/structure/shuttle/engine/heater,/obj/structure/window{dir = 1; icon_state = "window"},/obj/structure/window{dir = 4; icon_state = "window"},/turf/open/floor/plating,/area/shuttle/arrival)
"bR" = (/obj/structure/shuttle/engine/heater,/obj/structure/window{dir = 1; icon_state = "window"},/obj/structure/window{dir = 8},/turf/open/floor/plating,/area/shuttle/arrival)
"bS" = (/obj/structure/shuttle/engine/heater,/obj/structure/window{dir = 1; icon_state = "window"},/obj/structure/window{dir = 8},/obj/structure/window{dir = 4; icon_state = "window"},/turf/open/floor/plating,/area/shuttle/arrival)
"bT" = (/obj/structure/shuttle/engine/heater,/obj/structure/window{dir = 1; icon_state = "window"},/turf/open/floor/plating,/area/shuttle/arrival)
"bU" = (/obj/effect/turf_decal/tile/blue,/obj/effect/turf_decal/tile/blue{dir = 8},/obj/effect/turf_decal/tile/blue{dir = 4},/obj/machinery/vending/cigarette,/turf/open/floor/mineral/titanium/white,/area/shuttle/arrival)

(1,1,1) = {"
agagagagagagagacabadaHaeabadabacagagagagagagag
agagacafafafacacaiajaiakaiajaiacacafafafacagag
agacacamaRamamacaJalaTalaTalaNacamamamamacacag
acacalalalalalaoalalaQaVbHalalaoalalalbaalacac
afalalalaqalbzbAaXasasasasasaYalalalaqbBbCalaf
afazbDawaxalbEbFalalalalalalalbGbUalayazalawaf
afarbJawaxalalalaBaBaBaOaBaBaBalalalayazalawaf
ataPbbbcbdbeaIalbgahafafafahaCalaKbbbibjbeaSat
acaubkawaxblawacacanananananacacazbkayazbKavac
acazbkawaxblaSahanbmbPaLbPbmanahaPbkaMbLbMawac
afazbNbobpbqawafbQanbmbPbmanbRafazbnbrbsbqawaf
afalbOaUaqalalafaAbQanbSanbRaAafalalaqaUalalaf
afaDaaaaaaaabwafagaAbTaAbTaAagafbxaaaaaaaaaEaf
acacaaapapaaacacagagaAagaAagagacacaaapapaaacac
agacaaaFaFaaacagagagagagagagagagacaaaFaFaaacag
agagagaGaFagagagagagagagagagagagagagaGaFagagag
"}
