"a" = (/turf/open/space/basic,/area/space)
"b" = (/obj/effect/spawner/structure/window/shuttle,/obj/structure/grille,/turf/open/floor/plating,/area/shuttle/escape)
"c" = (/obj/structure/chair/comfy/shuttle,/obj/machinery/light{dir = 1},/turf/open/floor/mineral/plastitanium/red/brig,/area/shuttle/escape)
"e" = (/obj/structure/chair/comfy/shuttle{dir = 1},/obj/machinery/light,/turf/open/floor/mineral/plastitanium/red/brig,/area/shuttle/escape)
"h" = (/obj/effect/turf_decal/stripes/line{dir = 4},/turf/open/floor/mineral/plastitanium/red/brig,/area/shuttle/escape)
"n" = (/obj/item/radio/intercom{name = "Station Intercom (General)"; pixel_y = -31},/turf/open/floor/mineral/plastitanium/red/brig,/area/shuttle/escape)
"o" = (/obj/item/radio/intercom{dir = 4; name = "Station Intercom (General)"; pixel_y = 27},/turf/open/floor/mineral/plastitanium/red/brig,/area/shuttle/escape)
"p" = (/obj/machinery/door/airlock/titanium{name = "Emergency Shuttle Airlock"},/turf/open/floor/plating,/area/shuttle/escape)
"q" = (/turf/closed/wall/mineral/plastitanium,/area/shuttle/escape)
"r" = (/obj/structure/chair/comfy/shuttle{dir = 8},/obj/machinery/light{dir = 1},/obj/item/radio/intercom{dir = 4; name = "Station Intercom (General)"; pixel_y = 27},/turf/open/floor/mineral/titanium/white,/area/shuttle/escape)
"s" = (/obj/structure/closet/emcloset,/turf/open/floor/mineral/plastitanium/red/brig,/area/shuttle/escape)
"t" = (/obj/effect/turf_decal/stripes/line{dir = 4},/obj/structure/closet/emcloset,/turf/open/floor/mineral/plastitanium/red/brig,/area/shuttle/escape)
"u" = (/obj/machinery/door/airlock/security/glass{name = "Brig"; req_access_txt = "2"},/turf/open/floor/plating,/area/shuttle/escape)
"v" = (/obj/structure/chair/comfy/shuttle,/turf/open/floor/mineral/plastitanium/red/brig,/area/shuttle/escape)
"y" = (/obj/machinery/computer/emergency_shuttle{dir = 4},/turf/open/floor/mineral/titanium/white,/area/shuttle/escape)
"z" = (/obj/structure/chair/comfy/shuttle{dir = 8},/obj/machinery/status_display/evac{pixel_x = 32},/turf/open/floor/mineral/plastitanium/red/brig,/area/shuttle/escape)
"A" = (/obj/machinery/light{dir = 1},/turf/open/floor/mineral/plastitanium/red/brig,/area/shuttle/escape)
"B" = (/obj/structure/chair/comfy/shuttle{dir = 1},/turf/open/floor/mineral/plastitanium/red/brig,/area/shuttle/escape)
"D" = (/obj/machinery/door/airlock/titanium{name = "Emergency Shuttle Airlock"},/obj/docking_port/mobile/emergency{dir = 2; dwidth = 10; name = "Shitcurity Emergency Shuttle"},/turf/open/floor/plating,/area/shuttle/escape)
"E" = (/obj/machinery/computer/station_alert{dir = 4},/turf/open/floor/mineral/titanium/white,/area/shuttle/escape)
"F" = (/turf/closed/wall/mineral/titanium,/area/shuttle/escape)
"G" = (/obj/machinery/computer/communications{dir = 4},/turf/open/floor/mineral/titanium/white,/area/shuttle/escape)
"K" = (/obj/structure/chair/comfy/shuttle{dir = 4},/turf/open/floor/mineral/plastitanium/red/brig,/area/shuttle/escape)
"M" = (/turf/open/floor/mineral/plastitanium/red/brig,/area/shuttle/escape)
"N" = (/turf/open/floor/mineral/titanium/white,/area/shuttle/escape)
"O" = (/obj/structure/chair/comfy/shuttle{dir = 8},/turf/open/floor/mineral/plastitanium/red/brig,/area/shuttle/escape)
"P" = (/obj/structure/chair/comfy/shuttle{dir = 8},/obj/machinery/light,/turf/open/floor/mineral/titanium/white,/area/shuttle/escape)
"R" = (/obj/structure/shuttle/engine/propulsion{dir = 4},/turf/open/space/basic,/area/shuttle/escape)
"S" = (/obj/structure/chair/comfy/shuttle{dir = 1},/obj/machinery/status_display/evac{pixel_y = -32},/turf/open/floor/mineral/plastitanium/red/brig,/area/shuttle/escape)
"U" = (/obj/structure/shuttle/engine/heater{dir = 4},/obj/structure/window{dir = 8},/turf/open/space/basic,/area/shuttle/escape)
"X" = (/obj/structure/chair/comfy/shuttle,/obj/machinery/status_display/evac{pixel_y = 32},/turf/open/floor/mineral/plastitanium/red/brig,/area/shuttle/escape)
"Z" = (/obj/machinery/light,/turf/open/floor/mineral/plastitanium/red/brig,/area/shuttle/escape)

(1,1,1) = {"
aFFpbpFFFFFDbpFFFFFFaa
aFMMMMAMoMAMMMAMoMAFFa
FFeSBMMBBBMMMMMBBBMhUR
FFFFFMMFFFMMsMMFFFMhUR
bGrbMMMvXcMOFKMvXcMhUR
byNuMMMMMMMzFKMMMMMtqa
bEPbMMMeSBMOFKMeSBMhUR
FFFFFMMFFFMMsMMFFFMhUR
FFcXvMMvvvMMMMMvvvMhUR
aFMMMMZMnMZMMMZMnMZFFa
aFFbbbFFFFFbbbFFFFFFaa
"}
