"a" = (/turf/template_noop,/area/template_noop)
"b" = (/obj/effect/spawner/structure/window/shuttle,/turf/open/floor/plating,/area/shuttle/escape)
"c" = (/obj/structure/chair/comfy/shuttle,/obj/machinery/light/dim{dir = 1},/turf/open/floor/mineral/plastitanium/red/brig,/area/shuttle/escape)
"e" = (/obj/structure/chair/comfy/shuttle{dir = 1},/obj/machinery/light/dim,/turf/open/floor/mineral/plastitanium/red/brig,/area/shuttle/escape)
"f" = (/obj/item/radio/intercom{name = "Station Intercom (General)"; pixel_y = -31},/turf/open/floor/mineral/plastitanium/red/brig,/area/shuttle/escape)
"h" = (/obj/effect/turf_decal/stripes/line{dir = 4},/turf/open/floor/mineral/plastitanium/red/brig,/area/shuttle/escape)
"k" = (/obj/machinery/status_display/evac{pixel_y = -32},/obj/machinery/light{dir = 4},/obj/machinery/stasis,/turf/open/floor/mineral/titanium/white,/area/shuttle/escape)
"n" = (/obj/machinery/door/airlock/titanium{name = "Emergency Shuttle Airlock"},/turf/open/floor/mineral/plastitanium,/area/shuttle/escape)
"o" = (/obj/machinery/door/airlock/titanium{name = "Emergency Shuttle Airlock"},/obj/docking_port/mobile/emergency{dir = 2; dwidth = 6; name = "Shitcurity Emergency Shuttle"; port_direction = 4; preferred_direction = 8},/turf/open/floor/mineral/plastitanium,/area/shuttle/escape)
"p" = (/obj/item/radio/intercom{dir = 4; name = "Station Intercom (General)"; pixel_y = 27},/turf/open/floor/mineral/plastitanium/red/brig,/area/shuttle/escape)
"r" = (/obj/structure/chair/comfy/shuttle{dir = 8},/turf/open/floor/mineral/titanium/white,/area/shuttle/escape)
"s" = (/obj/machinery/light{dir = 4},/obj/item/radio/intercom{dir = 4; name = "Station Intercom (General)"; pixel_x = 28; pixel_y = -8},/obj/item/storage/firstaid,/obj/structure/table/reinforced,/turf/open/floor/mineral/titanium/white,/area/shuttle/escape)
"t" = (/obj/effect/turf_decal/stripes/line{dir = 4},/obj/structure/closet/emcloset/anchored,/obj/machinery/light/dim{dir = 4},/turf/open/floor/mineral/plastitanium/red/brig,/area/shuttle/escape)
"u" = (/obj/machinery/door/airlock/security/glass{name = "Brig"; req_access_txt = "2"},/turf/open/floor/mineral/plastitanium,/area/shuttle/escape)
"v" = (/obj/structure/chair/comfy/shuttle,/turf/open/floor/mineral/plastitanium/red/brig,/area/shuttle/escape)
"y" = (/obj/machinery/computer/emergency_shuttle{dir = 4},/turf/open/floor/mineral/titanium/white,/area/shuttle/escape)
"z" = (/obj/machinery/light/dim{dir = 8},/turf/open/floor/mineral/plastitanium/red/brig,/area/shuttle/escape)
"A" = (/obj/machinery/flasher{id = "shuttle flasher"; pixel_x = -24},/obj/effect/turf_decal/stripes/corner{dir = 8},/turf/open/floor/mineral/plastitanium/red/brig,/area/shuttle/escape)
"B" = (/obj/structure/chair/comfy/shuttle{dir = 1},/turf/open/floor/mineral/plastitanium/red/brig,/area/shuttle/escape)
"D" = (/obj/machinery/status_display/evac{pixel_y = 32},/obj/structure/chair/comfy/shuttle,/turf/open/floor/mineral/plastitanium/red/brig,/area/shuttle/escape)
"E" = (/obj/machinery/computer/station_alert{dir = 4},/turf/open/floor/mineral/titanium/white,/area/shuttle/escape)
"F" = (/turf/closed/wall/mineral/titanium,/area/shuttle/escape)
"G" = (/obj/machinery/computer/communications{dir = 4},/turf/open/floor/mineral/titanium/white,/area/shuttle/escape)
"K" = (/obj/effect/turf_decal/stripes/line{dir = 8},/turf/open/floor/mineral/plastitanium/red/brig,/area/shuttle/escape)
"M" = (/turf/open/floor/mineral/plastitanium/red/brig,/area/shuttle/escape)
"N" = (/turf/open/floor/mineral/titanium/white,/area/shuttle/escape)
"O" = (/obj/machinery/flasher{id = "shuttle flasher"; pixel_x = -24},/obj/effect/turf_decal/stripes/corner{dir = 1},/turf/open/floor/mineral/plastitanium/red/brig,/area/shuttle/escape)
"P" = (/obj/structure/chair/comfy/shuttle{dir = 8},/obj/machinery/button/flasher{id = "shuttle flasher"; pixel_x = 24; pixel_y = 6},/turf/open/floor/mineral/titanium/white,/area/shuttle/escape)
"R" = (/obj/structure/shuttle/engine/propulsion{dir = 4},/turf/template_noop,/area/shuttle/escape)
"S" = (/obj/structure/chair/comfy/shuttle{dir = 1},/obj/machinery/status_display/evac{pixel_y = -32},/turf/open/floor/mineral/plastitanium/red/brig,/area/shuttle/escape)
"U" = (/obj/structure/shuttle/engine/heater{dir = 4},/obj/structure/window/reinforced{dir = 8},/turf/open/floor/plating,/area/shuttle/escape)
"X" = (/obj/structure/chair/comfy/shuttle,/obj/machinery/status_display/evac{pixel_y = 32},/turf/open/floor/mineral/plastitanium/red/brig,/area/shuttle/escape)
"Z" = (/obj/machinery/status_display/evac{pixel_y = -32},/obj/structure/chair/comfy/shuttle{dir = 1},/turf/open/floor/mineral/plastitanium/red/brig,/area/shuttle/escape)

(1,1,1) = {"
aaaaFFFnbnFFFFFobnFFFa
aaaFFMMMMMMMpMMMMMMFFa
aFFFMMBBBeBBBBSeBBMhUR
FFsFzMFFbFFFFFFFbFMhUR
bGrFAMbvXcDvbvvcXvMhUR
byNuKMMMMMMMMMMMMMMtFa
bEPFOMbBSeBBbBZeSBMhUR
FFkFzMFFbFFFFFFFbFMhUR
aFFFMMvvvcXvvvvcvvMhUR
aaaFFMMMMMMMfMMMMMMFFa
aaaaFFFbbbFFFFFbbbFFFa
"}
