"a" = (/turf/template_noop,/area/template_noop)
"e" = (/obj/machinery/door/airlock/titanium{name = "Emergency Shuttle Airlock"},/obj/docking_port/mobile/emergency{dir = 8; dwidth = 3; name = "Shitcurity Emergency Shuttle"; port_direction = 4},/turf/open/floor/mineral/plastitanium,/area/shuttle/escape)
"j" = (/obj/structure/chair/comfy/shuttle,/turf/open/floor/mineral/titanium/white,/area/shuttle/escape)
"o" = (/obj/structure/chair/comfy/shuttle,/obj/machinery/light/dim{dir = 4},/turf/open/floor/mineral/titanium/white,/area/shuttle/escape)
"r" = (/obj/item/radio/intercom{name = "Station Intercom (General)"},/turf/closed/wall/mineral/titanium,/area/shuttle/escape)
"s" = (/obj/machinery/flasher{id = "shuttle flasher"},/turf/closed/wall/mineral/titanium,/area/shuttle/escape)
"x" = (/obj/structure/shuttle/engine/propulsion{dir = 1},/turf/closed/wall/mineral/titanium,/area/shuttle/escape)
"y" = (/obj/effect/spawner/structure/window/shuttle,/turf/open/floor/plating,/area/shuttle/escape)
"A" = (/obj/structure/chair/comfy/shuttle,/obj/item/radio/intercom{name = "Station Intercom (General)"; pixel_x = 32},/obj/machinery/button/flasher{id = "shuttle flasher"; pixel_x = 24; pixel_y = -8},/obj/machinery/light{dir = 4},/obj/machinery/flasher{id = "shuttle flasher"; pixel_x = 30; pixel_y = 2},/turf/open/floor/mineral/plastitanium/red/brig,/area/shuttle/escape)
"B" = (/obj/machinery/computer/emergency_shuttle{dir = 1},/turf/open/floor/mineral/plastitanium/red/brig,/area/shuttle/escape)
"F" = (/turf/closed/wall/mineral/titanium,/area/shuttle/escape)
"G" = (/obj/structure/chair/comfy/shuttle,/obj/machinery/light/dim{dir = 8},/turf/open/floor/mineral/titanium/white,/area/shuttle/escape)
"P" = (/obj/structure/lattice,/turf/open/space,/area/shuttle/escape)
"Z" = (/obj/machinery/door/airlock/titanium{name = "Emergency Shuttle Airlock"},/turf/open/floor/mineral/plastitanium,/area/shuttle/escape)

(1,1,1) = {"
xZxZxaaaxexZx
FjsjFPaPFjsjF
FGroFPPPFGroF
FyFyFPaPFyFyF
aPPPPPPPPPPPa
aaPaPxFxPaPaa
aaPPPZAFPPPaa
aaaaPFBFPaaaa
aaaaaFyFaaaaa
"}
